4
4
3 2
20 20
- - - - 0 0 0 0 0 0 0 0 0 0 x 0 0 0 0 0
- - - - 0 0 0 0 0 0 0 0 0 x x x 0 0 0 0
- - - - 0 0 0 0 0 b 0 0 0 0 x 0 0 0 0 0
- - - - 0 0 0 0 0 0 0 0 0 0 0 0 0 0 0 0
0 0 0 0 0 0 0 0 0 0 0 0 0 0 0 0 0 0 b 0
0 c 0 0 0 0 0 0 0 0 0 0 0 0 0 0 0 0 0 0
0 0 0 0 0 0 0 0 0 0 0 0 0 0 0 0 0 0 0 0
0 0 0 0 0 0 0 0 0 0 0 0 0 0 0 0 0 0 0 0
0 0 0 0 0 0 0 1 2 3 3 0 0 0 0 0 0 0 0 i
0 0 0 0 0 0 0 4 1 2 3 0 0 0 0 0 0 0 0 0
0 0 0 0 0 0 0 4 4 1 2 0 0 0 0 0 0 0 0 0
0 0 0 0 0 0 0 0 0 0 0 0 0 0 0 0 0 0 0 0
0 0 0 0 0 0 0 0 0 0 0 0 0 0 0 0 c 0 0 0
0 0 0 0 0 0 0 0 0 0 0 0 0 0 0 0 0 0 0 0
0 b 0 0 0 0 0 0 0 0 0 0 0 0 0 0 0 0 0 0
0 0 0 0 0 0 0 0 0 0 0 0 0 0 0 0 0 0 0 0
0 0 0 0 0 0 0 0 0 0 0 0 0 0 0 0 - - - -
0 0 0 0 0 0 0 0 0 b 0 0 0 0 0 0 - - - -
0 0 0 0 0 0 0 0 0 0 0 0 0 0 0 0 - - - -
c 0 0 0 0 0 0 0 0 0 0 0 0 i 0 0 - - - -
4 0 6 <-> 19 0 2
4 1 6 <-> 19 1 2
4 2 6 <-> 19 2 2
4 3 6 <-> 19 3 2
15 16 2 <-> 0 16 6
15 17 2 <-> 0 17 6
15 18 2 <-> 0 18 6
15 19 2 <-> 0 19 6
