4
6
0 9
29 29
- - - - - - - - - - - 0 0 0 0 0 0 0 - - - - - - - - - - -
- - - - - - - - - - - 0 x x x x x 0 - - - - - - - - - - -
- - - - - - - - - - - 0 0 x x x 0 0 - - - - - - - - - - -
- - - - - - - - - - - 0 0 0 x 0 0 0 - - - - - - - - - - -
- - - - - c - - - - - 0 0 0 0 0 0 0 - - - - - - - - - - -
- - - - - 2 - - - - - 0 0 0 0 0 0 0 - - - - 2 3 c - - - -
- - - - - 1 - - - - - 0 0 0 0 0 0 0 - - - - - - - - - - -
- - - - - - - - - - - 0 0 0 0 0 0 0 - - - - - - - - - - -
- - - - - - - - - - - 0 0 0 0 0 0 0 - - - - - - - - - - -
- - - - - - - - - - - 0 0 0 0 0 0 0 - - - - - - - - - - -
- - - - - - - - - - - 0 0 0 0 0 0 0 - - - - - - - - - - -
0 0 0 0 0 0 0 0 0 0 0 i 0 0 0 0 0 i 0 0 0 0 0 0 0 0 0 0 0
0 x 0 0 0 0 0 0 0 0 0 0 0 0 0 0 0 0 0 0 0 0 0 0 0 0 0 x 0
0 x x 0 0 0 0 0 0 0 0 0 0 0 0 0 0 0 0 0 0 0 0 0 0 0 x x 0
0 x x x 0 0 0 0 0 0 0 0 0 0 b 0 0 0 0 0 0 0 0 0 0 x x x 0
0 x x 0 0 0 0 0 0 0 0 0 0 0 0 0 0 0 0 0 0 0 0 0 0 0 x x 0
0 x 0 0 0 0 0 0 0 0 0 0 0 0 0 0 0 0 0 0 0 0 0 0 0 0 0 x 0
0 0 0 0 0 0 0 0 0 0 0 i 0 0 0 0 0 i 0 0 0 0 0 0 0 0 0 0 0
- - - - - - - - - - - 0 0 0 0 0 0 0 - - - - - - - - - - -
- - - - - - - - - - - 0 0 0 0 0 0 0 - - - - - - - - - - -
- - - - - - - - - - - 0 0 0 0 0 0 0 - - - - - - - - - - -
- - - - - - - - - - - 0 0 0 0 0 0 0 - - - - - - - - - - -
- - - - - - - - - - - 0 0 0 0 0 0 0 - - - - - 3 - - - - -
- - - - c 1 4 - - - - 0 0 0 0 0 0 0 - - - - - 4 - - - - -
- - - - - - - - - - - 0 0 0 0 0 0 0 - - - - - c - - - - -
- - - - - - - - - - - 0 0 0 x 0 0 0 - - - - - - - - - - -
- - - - - - - - - - - 0 0 x x x 0 0 - - - - - - - - - - -
- - - - - - - - - - - 0 x x x x x 0 - - - - - - - - - - -
- - - - - - - - - - - 0 0 0 0 0 0 0 - - - - - - - - - - -
11 5 6 <-> 5 11 0
11 6 6 <-> 6 11 0
17 5 2 <-> 24 11 0
17 6 2 <-> 23 11 0
11 24 6 <-> 5 17 4
11 23 6 <-> 6 17 4
17 24 2 <-> 24 17 4
17 23 2 <-> 23 17 4



