4
2
3 2
47 47
- - - - - - - - - - - - - - - - - 0 0 0 0 0 0 0 0 0 0 0 0 0 - - - - - - - - - - - - - - - - -
- - - - - - - - - - - - - - 0 0 0 0 0 0 0 0 0 0 0 0 0 0 0 0 0 0 0 - - - - - - - - - - - - - -
- - - - - - - - - - - - 0 0 0 x x 0 0 0 0 0 0 0 0 0 0 0 0 0 x x 0 0 0 - - - - - - - - - - - -
- - - - - - - - - - 0 0 0 0 0 x x 0 0 0 0 0 0 0 0 0 0 0 0 0 x x 0 0 0 0 0 - - - - - - - - - -
- - - - - - - - - 0 0 0 0 0 0 0 0 0 0 0 0 0 0 0 0 0 0 0 0 0 0 0 0 0 0 0 0 0 - - - - - - - - -
- - - - - - - - 0 0 0 0 0 0 0 0 0 0 0 0 0 0 3 x 4 0 0 0 0 0 0 0 0 0 0 0 0 0 0 - - - - - - - -
- - - - - - - 0 0 0 0 0 0 0 0 0 0 0 0 0 0 0 x x x 0 0 0 0 0 0 0 0 0 0 0 0 0 0 0 - - - - - - -
- - - - - - 0 0 0 0 0 0 0 0 0 0 0 0 0 0 0 0 4 x 3 0 0 0 0 0 0 0 0 0 0 0 0 0 0 0 0 - - - - - -
- - - - - 0 0 0 0 0 0 0 0 0 0 0 0 0 0 0 0 0 0 0 0 0 0 0 0 0 0 0 0 0 0 0 0 0 0 0 0 0 - - - - -
- - - - 0 0 0 0 0 0 x 0 0 0 0 0 0 0 0 0 0 0 0 0 0 0 0 0 0 0 0 0 0 0 0 0 x 0 0 0 0 0 0 - - - -
- - - 0 0 0 0 0 0 x x x 0 0 0 0 0 0 0 0 0 0 0 0 0 0 0 0 0 0 0 0 0 0 0 x x x 0 0 0 0 0 0 - - -
- - - 0 0 0 0 0 0 0 x 0 0 0 0 0 0 0 0 0 0 0 0 0 0 0 0 0 0 0 0 0 0 0 0 0 x 0 0 0 0 0 0 0 - - -
- - 0 0 0 0 0 0 0 0 0 0 0 0 0 0 0 0 0 0 0 0 0 0 0 0 0 0 0 0 0 0 0 0 0 0 0 0 0 0 0 0 0 0 0 - -
- - 0 0 0 0 0 0 0 0 0 0 0 0 0 0 0 0 0 0 0 0 0 0 0 0 0 0 0 0 0 0 0 0 0 0 0 0 0 0 0 0 0 0 0 - -
- 0 0 0 0 0 0 0 x 0 0 0 0 0 0 0 0 0 0 - - - - - - - - - 0 0 0 0 0 0 0 0 0 0 0 0 0 0 0 0 0 0 -
- 0 0 0 c 0 0 0 x 0 0 0 0 0 c 0 0 0 - - - - - - - - - - - 0 0 0 0 0 0 0 0 0 0 0 b 0 0 0 0 0 -
- 0 0 0 0 0 0 0 x 0 0 0 0 0 0 0 - - - - - - - - - - - - - - - 0 0 0 0 0 0 0 0 0 0 0 0 0 0 0 -
0 0 0 0 0 0 0 0 x 0 0 0 0 0 0 0 - - - - - - - - - - - - - - - 0 0 0 0 0 0 0 0 0 0 0 0 0 0 0 0
0 0 0 0 0 0 0 c x c 0 0 0 0 0 - - - - - - - - - - - - - - - - - 0 0 0 0 0 0 0 0 0 0 0 0 0 0 0
0 0 0 0 0 0 0 0 0 0 0 0 0 0 - - - - - - - - - - - - - - - - - - - 0 0 b 0 0 0 0 0 0 0 0 0 0 0
0 0 0 x 0 0 0 0 0 0 0 0 0 0 - - - - - - - - - - - - - - - - - - - 0 0 0 0 0 0 0 0 0 0 x 0 0 0
0 0 0 0 x 0 0 0 0 0 0 0 0 0 - - - - - - - - - - - - - - - - - - - 0 0 0 0 0 0 0 0 0 x 0 0 0 0
0 0 0 x 0 0 0 0 0 x 0 0 0 0 - - - - - - - - - - - - - - - - - - - 0 0 0 0 x 0 0 0 0 0 x 0 0 0
0 0 x 0 0 0 0 0 0 0 0 x 0 0 - - - - - - - - - - - - - - - - - - - 0 0 x 0 0 0 0 0 0 0 0 x 0 0
0 0 0 x 0 0 0 0 0 x 0 0 0 0 - - - - - - - - - - - - - - - - - - - 0 0 0 0 x 0 0 0 0 0 x 0 0 0
0 0 0 0 x 0 0 0 0 0 0 0 0 0 - - - - - - - - - - - - - - - - - - - 0 0 0 0 0 0 0 0 0 x 0 0 0 0
0 0 0 x 0 0 0 0 0 0 0 0 0 0 - - - - - - - - - - - - - - - - - - - 0 0 0 0 0 0 0 0 0 0 x 0 0 0
0 0 0 0 0 0 0 0 0 0 0 b 0 0 - - - - - - - - - - - - - - - - - - - 0 0 0 0 0 0 0 0 0 0 0 0 0 0
0 0 0 0 0 0 0 0 0 0 0 0 0 0 0 - - - - - - - - - - - - - - - - - 0 0 0 0 0 c x c 0 0 0 0 0 0 0
0 0 0 0 0 0 0 0 0 0 0 0 0 0 0 0 - - - - - - - - - - - - - - - 0 0 0 0 0 0 0 x 0 0 0 0 0 0 0 0
- 0 0 0 0 0 0 0 0 0 0 0 0 0 0 0 - - - - - - - - - - - - - - - 0 0 0 0 0 0 0 x 0 0 0 0 0 0 0 -
- 0 0 0 0 0 b 0 0 0 0 0 0 0 0 0 0 0 - - - - - - - - - - - 0 0 0 c 0 0 0 0 0 x 0 0 0 c 0 0 0 -
- 0 0 0 0 0 0 0 0 0 0 0 0 0 0 0 0 0 0 - - - - - - - - - 0 0 0 0 0 0 0 0 0 0 x 0 0 0 0 0 0 0 -
- - 0 0 0 0 0 0 0 0 0 0 0 0 0 0 0 0 0 0 0 0 0 0 0 0 0 0 0 0 0 0 0 0 0 0 0 0 0 0 0 0 0 0 0 - -
- - 0 0 0 0 0 0 0 0 0 0 0 0 0 0 0 0 0 0 0 0 0 0 0 0 0 0 0 0 0 0 0 0 0 0 0 0 0 0 0 0 0 0 0 - -
- - - 0 0 0 0 0 0 0 x 0 0 0 0 0 0 0 0 0 0 0 0 0 0 0 0 0 0 0 0 0 0 0 0 0 x 0 0 0 0 0 0 0 - - -
- - - 0 0 0 0 0 0 x x x 0 0 0 0 0 0 0 0 0 0 0 0 0 0 0 0 0 0 0 0 0 0 0 x x x 0 0 0 0 0 0 - - -
- - - - 0 0 0 0 0 0 x 0 0 0 0 0 0 0 0 0 0 0 0 0 0 0 0 0 0 0 0 0 0 0 0 0 x 0 0 0 0 0 0 - - - -
- - - - - 0 0 0 0 0 0 0 0 0 0 0 0 0 0 0 0 0 0 0 0 0 0 0 0 0 0 0 0 0 0 0 0 0 0 0 0 0 - - - - -
- - - - - - 0 0 0 0 0 0 0 0 0 0 0 0 0 0 0 0 1 x 2 0 0 0 0 0 0 0 0 0 0 0 0 0 0 0 0 - - - - - -
- - - - - - - 0 0 0 0 0 0 0 0 0 0 0 0 0 0 0 x x x 0 0 0 0 0 0 0 0 0 0 0 0 0 0 0 - - - - - - -
- - - - - - - - 0 0 0 0 0 0 0 0 0 0 0 0 0 0 2 x 1 0 0 0 0 0 0 0 0 0 0 0 0 0 0 - - - - - - - -
- - - - - - - - - 0 0 0 0 0 0 0 0 0 0 0 0 0 0 0 0 0 0 0 0 0 0 0 0 0 0 0 0 0 - - - - - - - - -
- - - - - - - - - - 0 0 0 0 0 x x 0 0 0 0 0 0 0 0 0 0 0 0 0 x x 0 0 0 0 0 - - - - - - - - - -
- - - - - - - - - - - - 0 0 0 x x 0 0 0 0 0 0 0 0 0 0 0 0 0 x x 0 0 0 - - - - - - - - - - - -
- - - - - - - - - - - - - - 0 0 0 0 0 0 0 0 0 0 0 0 0 0 0 0 0 0 0 - - - - - - - - - - - - - -
- - - - - - - - - - - - - - - - - 0 0 0 0 0 0 0 0 0 0 0 0 0 - - - - - - - - - - - - - - - - -
0 24 6 <-> 46 24 2
24 13 4 <-> 24 33 0
