8
3
2 1
32 32
- - - - - - - - - - - - 0 0 0 0 0 0 0 0 - - - - - - - - - - - -
- - - - - - - - - - - - 0 0 0 0 0 0 0 0 - - - - - - - - - - - -
- - - - - - - - - - - - 0 0 0 0 0 0 0 0 - - - - - - - - - - - -
- - - - - - - - - - - - 0 0 0 1 2 0 0 0 - - - - - - - - - - - -
- - - - - - - - - - - - 0 0 0 2 1 0 0 0 - - - - - - - - - - - -
- - - - - - - - - - - - 0 0 0 x x 0 0 0 - - - - - - - - - - - -
- - - - - - - - - - - - 0 0 0 0 0 0 0 0 - - - - - - - - - - - -
- - - - - - - - - - - - 0 0 0 0 0 0 0 0 - - - - - - - - - - - -
- - - - - - - - 0 0 0 0 0 0 0 0 0 0 0 0 0 0 0 0 - - - - - - - -
- - - - - - - - 0 b 0 0 0 0 0 0 0 0 0 0 0 0 b 0 - - - - - - - -
- - - - - - - - 0 0 0 0 0 0 0 0 0 0 0 0 0 0 0 0 - - - - - - - -
- - - - - - - - 0 0 0 0 0 0 0 0 0 0 0 0 0 0 0 0 - - - - - - - -
0 0 0 0 0 0 0 0 0 0 0 0 c 0 0 0 0 0 0 c 0 0 0 0 0 0 0 0 0 0 0 0
0 0 0 0 0 0 0 0 0 0 0 0 0 0 0 0 0 0 0 0 0 0 0 0 0 0 0 0 0 0 0 0
0 0 0 0 0 0 0 0 0 0 0 0 0 0 0 0 0 0 0 0 0 0 0 0 0 0 0 0 0 0 0 0
0 0 0 8 7 x 0 0 0 0 0 0 0 0 0 b b 0 0 0 0 0 0 0 0 0 x 4 3 0 0 0
0 0 0 7 8 x 0 0 0 0 0 0 0 0 0 b b 0 0 0 0 0 0 0 0 0 x 3 4 0 0 0
0 0 0 0 0 0 0 0 0 0 0 0 0 0 0 0 0 0 0 0 0 0 0 0 0 0 0 0 0 0 0 0
0 0 0 0 0 0 0 0 0 0 0 0 0 0 0 0 0 0 0 0 0 0 0 0 0 0 0 0 0 0 0 0
0 0 0 0 0 0 0 0 0 0 0 0 c 0 0 0 0 0 0 c 0 0 0 0 0 0 0 0 0 0 0 0
- - - - - - - - 0 0 0 0 0 0 0 0 0 0 0 0 0 0 0 0 - - - - - - - -
- - - - - - - - 0 0 0 0 0 0 0 0 0 0 0 0 0 0 0 0 - - - - - - - -
- - - - - - - - 0 b 0 0 0 0 0 0 0 0 0 0 0 0 b 0 - - - - - - - -
- - - - - - - - 0 0 0 0 0 0 0 0 0 0 0 0 0 0 0 0 - - - - - - - -
- - - - - - - - - - - - 0 0 0 0 0 0 0 0 - - - - - - - - - - - -
- - - - - - - - - - - - 0 0 0 0 0 0 0 0 - - - - - - - - - - - -
- - - - - - - - - - - - 0 0 0 x x 0 0 0 - - - - - - - - - - - -
- - - - - - - - - - - - 0 0 0 5 6 0 0 0 - - - - - - - - - - - -
- - - - - - - - - - - - 0 0 0 6 5 0 0 0 - - - - - - - - - - - -
- - - - - - - - - - - - 0 0 0 0 0 0 0 0 - - - - - - - - - - - -
- - - - - - - - - - - - 0 0 0 0 0 0 0 0 - - - - - - - - - - - -
- - - - - - - - - - - - 0 0 0 0 0 0 0 0 - - - - - - - - - - - -
19 3 2 <-> 28 12 0
19 4 2 <-> 27 12 0
19 2 3 <-> 28 12 1
19 3 3 <-> 27 12 1
19 4 3 <-> 26 12 1
19 3 1 <-> 29 12 7
19 4 1 <-> 28 12 7
19 5 1 <-> 27 12 7
12 3 6 <-> 3 12 0
12 4 6 <-> 4 12 0
12 2 5 <-> 3 12 7
12 3 5 <-> 4 12 7
12 4 5 <-> 5 12 7
12 3 7 <-> 2 12 1
12 4 7 <-> 3 12 1
12 5 7 <-> 4 12 1
19 28 2 <-> 28 19 4
19 27 2 <-> 27 19 4
19 29 1 <-> 28 19 3
19 28 1 <-> 27 19 3
19 27 1 <-> 26 19 3
19 28 3 <-> 29 19 5
19 27 3 <-> 28 19 5
19 26 3 <-> 27 19 5
12 28 6 <-> 3 19 4
12 27 6 <-> 4 19 4
12 29 7 <-> 3 19 5
12 28 7 <-> 4 19 5
12 27 7 <-> 5 19 5
12 28 5 <-> 2 19 3
12 27 5 <-> 3 19 3
12 26 5 <-> 4 19 3
