4
0
0 1
25 25
x 1 0 0 0 0 0 0 0 0 0 0 b 0 0 0 0 0 0 0 0 0 0 1 x
2 x 1 0 0 0 0 0 0 0 0 0 b 0 0 0 0 0 0 0 0 0 1 x 4
0 2 x 1 0 0 0 0 0 0 0 0 b 0 0 0 0 0 0 0 0 1 x 4 0
0 0 2 x 1 0 0 0 0 0 0 0 b 0 0 0 0 0 0 0 1 x 4 0 0
0 0 0 2 x 1 0 0 0 0 0 0 b 0 0 0 0 0 0 1 x 4 0 0 0
0 0 0 0 2 - - - - - - - - - - - - - - - 4 0 0 0 0
0 0 0 0 0 - - - - - - - - - - - - - - - 0 0 0 0 0
0 0 0 0 0 - - - - - - - - - - - - - - - 0 0 0 0 0
0 0 0 0 0 - - - - - - - - - - - - - - - 0 0 0 0 0
0 0 0 0 0 - - - - - - - - - - - - - - - 0 0 0 0 0
0 0 0 0 0 - - - - - - - - - - - - - - - 0 0 0 0 0
0 0 0 0 0 - - - - - - - x - - - - - - - 0 0 0 0 0
b b b b b - - - - - - x c x - - - - - - b b b b b
0 0 0 0 0 - - - - - - - x - - - - - - - 0 0 0 0 0
0 0 0 0 0 - - - - - - - - - - - - - - - 0 0 0 0 0
0 0 0 0 0 - - - - - - - - - - - - - - - 0 0 0 0 0
0 0 0 0 0 - - - - - - - - - - - - - - - 0 0 0 0 0
0 0 0 0 0 - - - - - - - - - - - - - - - 0 0 0 0 0
0 0 0 0 0 - - - - - - - - - - - - - - - 0 0 0 0 0
0 0 0 0 2 - - - - - - - - - - - - - - - 4 0 0 0 0
0 0 0 2 x 3 0 0 0 0 0 0 b 0 0 0 0 0 0 3 x 4 0 0 0
0 0 2 x 3 0 0 0 0 0 0 0 b 0 0 0 0 0 0 0 3 x 4 0 0
0 2 x 3 0 0 0 0 0 0 0 0 b 0 0 0 0 0 0 0 0 3 x 4 0
2 x 3 0 0 0 0 0 0 0 0 0 b 0 0 0 0 0 0 0 0 0 3 x 4
x 3 0 0 0 0 0 0 0 0 0 0 b 0 0 0 0 0 0 0 0 0 0 3 x
4 5 2 <-> 20 5 6
4 6 2 <-> 20 6 6
4 7 2 <-> 20 7 6
4 8 2 <-> 20 8 6
4 9 2 <-> 20 9 6
4 10 2 <-> 20 10 6
4 11 2 <-> 20 11 6
4 12 2 <-> 20 12 6
4 13 2 <-> 20 13 6
4 14 2 <-> 20 14 6
4 15 2 <-> 20 15 6
4 16 2 <-> 20 16 6
4 17 2 <-> 20 17 6
4 18 2 <-> 20 18 6
4 19 2 <-> 20 19 6
5 4 4 <-> 5 20 0
6 4 4 <-> 6 20 0
7 4 4 <-> 7 20 0
8 4 4 <-> 8 20 0
9 4 4 <-> 9 20 0
10 4 4 <-> 10 20 0
11 4 4 <-> 11 20 0
12 4 4 <-> 12 20 0
13 4 4 <-> 13 20 0
14 4 4 <-> 14 20 0
15 4 4 <-> 15 20 0
16 4 4 <-> 16 20 0
17 4 4 <-> 17 20 0
18 4 4 <-> 18 20 0
19 4 4 <-> 19 20 0
