2
0
0 1
9 20 
0 0 0 0 0 0 0 0 0 1 2 0 0 0 0 0 0 0 0 0
0 0 0 0 0 0 0 0 0 1 2 0 0 0 0 0 0 0 0 0
i 0 0 0 0 0 0 0 0 1 2 0 0 0 0 0 0 0 0 i
0 0 0 0 0 0 0 0 0 1 2 0 0 0 0 0 0 0 0 0
0 0 0 0 0 0 0 0 0 1 2 0 0 0 0 0 0 0 0 0
- - - - - - - - - - - - - - - - - - - -
1 x c - - - - - - - - - - - - - - c x 2
1 x c - - - - - - - - - - - - - - c x 2 
1 x c - - - - - - - - - - - - - - c x 2



